{
	"levels": [{
        "hint": "1 of 10,,Start,Out,Simple",
		"start": [0, 0, 0, 0, 0, 0, 0, 0, 0, 0,
			0, 0, 0, 0, 0, 0, 0, 0, 0, 0,
			0, 0, 0, 0, 0, 0, 0, 0, 0, 0,
			0, 0, 0, 0, 0, 0, 0, 0, 0, 0,
			0, 0, 0, 0, 0, 0, 0, 0, 0, 0,
			0, 0, 0, 0, 0, 0, 0, 0, 0, 0,
			0, 0, 0, 0, 0, 0, 0, 0, 0, 0,
			0, 0, 0, 0, 0, 0, 0, 0, 0, 0,
			0, 0, 0, 0, 0, 0, 0, 0, 0, 0,
			0, 0, 0, 0, 0, 0, 0, 0, 0, 0,
			0, 0, 0, 0, 0, 0, 0, 0, 0, 0,
			0, 0, 0, 0, 0, 0, 0, 0, 0, 0,
			0, 0, 0, 0, 0, 0, 0, 0, 0, 0,
			0, 0, 0, 0, 0, 0, 0, 0, 0, 0,
			0, 0, 0, 0, 0, 0, 0, 0, 0, 0,
			0, 0, 0, 0, 0, 0, 0, 0, 0, 0,
            0, 0, 0, 0, 0, 0, 0, 0, 0, 0,
            0, 0, 0, 0, 0, 0, 0, 0, 0, 0,
            0, 0, 1, 1, 0, 0, 0, 0, 0, 0,
            0, 0, 1, 1, 0, 0, 0, 0, 0, 0
		],
		"shapes": [0]
	},
    {
        "hint": "2 of 10,,Think,Ahead",
		"start": [0, 0, 0, 0, 0, 0, 0, 0, 0, 0,
			0, 0, 0, 0, 0, 0, 0, 0, 0, 0,
			0, 0, 0, 0, 0, 0, 0, 0, 0, 0,
			0, 0, 0, 0, 0, 0, 0, 0, 0, 0,
			0, 0, 0, 0, 0, 0, 0, 0, 0, 0,
			0, 0, 0, 0, 0, 0, 0, 0, 0, 0,
			0, 0, 0, 0, 0, 0, 0, 0, 0, 0,
			0, 0, 0, 0, 0, 0, 0, 0, 0, 0,
			0, 0, 0, 0, 0, 0, 0, 0, 0, 0,
			0, 0, 0, 0, 0, 0, 0, 0, 0, 0,
			0, 0, 0, 0, 0, 0, 0, 0, 0, 0,
			0, 0, 0, 0, 0, 0, 0, 0, 0, 0,
			0, 0, 0, 0, 0, 0, 0, 0, 0, 0,
			0, 0, 0, 0, 0, 0, 0, 0, 0, 0,
			0, 0, 0, 0, 0, 0, 0, 0, 0, 0,
			0, 0, 0, 0, 0, 0, 0, 0, 0, 0,
            0, 0, 0, 0, 0, 0, 0, 0, 0, 0,
            0, 0, 0, 0, 0, 0, 0, 0, 0, 0,
            0, 0, 0, 1, 1, 1, 1, 1, 0, 0,
            0, 0, 0, 0, 1, 1, 1, 0, 0, 0
		],
		"shapes": [4, 5]
	},
    {
        "hint": "3 of 10,,Q and E,Rotate",
		"start": [0, 0, 0, 0, 0, 0, 0, 0, 0, 0,
			0, 0, 0, 0, 0, 0, 0, 0, 0, 0,
			0, 0, 0, 0, 0, 0, 0, 0, 0, 0,
			0, 0, 0, 0, 0, 0, 0, 0, 0, 0,
			0, 0, 0, 0, 0, 0, 0, 0, 0, 0,
			0, 0, 0, 0, 0, 0, 0, 0, 0, 0,
			0, 0, 0, 0, 0, 0, 0, 0, 0, 0,
			0, 0, 0, 0, 0, 0, 0, 0, 0, 0,
			0, 0, 0, 0, 0, 0, 0, 0, 0, 0,
			0, 0, 0, 0, 0, 0, 0, 0, 0, 0,
			0, 0, 0, 0, 0, 0, 0, 0, 0, 0,
			0, 0, 0, 0, 0, 0, 0, 0, 0, 0,
			0, 0, 0, 0, 0, 0, 0, 0, 0, 0,
			0, 0, 0, 0, 0, 0, 0, 0, 0, 0,
			0, 0, 0, 0, 0, 0, 0, 0, 0, 0,
			0, 1, 1, 0, 0, 0, 0, 0, 0, 0,
			0, 1, 1, 1, 0, 0, 0, 0, 0, 0,
			0, 1, 1, 1, 1, 0, 0, 0, 0, 0,
			0, 1, 1, 1, 1, 0, 0, 0, 0, 0,
			0, 0, 1, 1, 1, 0, 0, 0, 0, 0
		],
		"shapes": [5, 4, 2, 0]
	},
	{
        "hint": "4 of 10",
		"start": [0, 0, 0, 0, 0, 0, 0, 0, 0, 0,
			0, 0, 0, 0, 0, 0, 0, 0, 0, 0,
			0, 0, 0, 0, 0, 0, 0, 0, 0, 0,
			0, 0, 0, 0, 0, 0, 0, 0, 0, 0,
			0, 0, 0, 0, 0, 0, 0, 0, 0, 0,
			0, 0, 0, 0, 0, 0, 0, 0, 0, 0,
			0, 0, 0, 0, 0, 0, 0, 0, 0, 0,
			0, 0, 0, 0, 0, 0, 0, 0, 0, 0,
			0, 0, 0, 0, 0, 0, 0, 0, 0, 0,
			0, 0, 0, 0, 0, 0, 0, 0, 0, 0,
			0, 0, 0, 0, 0, 0, 0, 0, 0, 0,
			0, 0, 0, 0, 0, 0, 0, 0, 0, 0,
			0, 0, 0, 0, 0, 0, 0, 0, 0, 0,
			0, 0, 0, 0, 0, 1, 0, 0, 0, 0,
			0, 0, 0, 0, 0, 1, 1, 0, 0, 0,
			0, 0, 0, 0, 0, 1, 1, 0, 1, 0,
            0, 0, 0, 0, 0, 1, 1, 0, 1, 1,
            0, 0, 0, 0, 0, 1, 1, 1, 1, 1,
            0, 0, 0, 0, 0, 0, 1, 1, 1, 1,
            0, 0, 0, 0, 0, 1, 1, 1, 1, 1
		],
		"shapes": [3, 3, 4, 1, 1, 0]
	},
	{
        "hint": "5 of 10",
		"start": [0, 0, 0, 0, 0, 0, 0, 0, 0, 0,
			0, 0, 0, 0, 0, 0, 0, 0, 0, 0,
			0, 0, 0, 0, 0, 0, 0, 0, 0, 0,
			0, 0, 0, 0, 0, 0, 0, 0, 0, 0,
			0, 0, 0, 0, 0, 0, 0, 0, 0, 0,
			0, 0, 0, 0, 0, 0, 0, 0, 0, 0,
			0, 0, 0, 0, 0, 0, 0, 0, 0, 0,
			0, 0, 0, 0, 0, 0, 0, 0, 0, 0,
			0, 0, 0, 0, 0, 0, 0, 0, 0, 0,
			0, 0, 0, 0, 0, 0, 0, 0, 0, 0,
			0, 0, 0, 0, 0, 0, 0, 0, 0, 0,
			0, 0, 0, 0, 0, 0, 0, 0, 0, 0,
			0, 0, 0, 0, 0, 0, 0, 0, 0, 0,
			0, 0, 0, 0, 0, 0, 0, 0, 0, 0,
			0, 0, 0, 0, 1, 1, 1, 1, 1, 0,
			0, 0, 0, 1, 1, 1, 1, 1, 1, 1,
            0, 0, 0, 1, 1, 1, 0, 0, 0, 0,
            0, 0, 0, 0, 1, 1, 0, 0, 0, 0,
            0, 0, 0, 1, 1, 1, 0, 0, 0, 0,
            0, 0, 1, 1, 1, 1, 0, 0, 0, 0
		],
		"shapes": [5, 5, 4, 4, 4, 4]
	},
    {
        "hint": "6 of 10",
		"start": [0, 0, 0, 0, 0, 0, 0, 0, 0, 0,
			0, 0, 0, 0, 0, 0, 0, 0, 0, 0,
			0, 0, 0, 0, 0, 0, 0, 0, 0, 0,
			0, 0, 0, 0, 0, 0, 0, 0, 0, 0,
			0, 0, 0, 0, 0, 0, 0, 0, 0, 0,
			0, 0, 0, 0, 0, 0, 0, 0, 0, 0,
			0, 0, 0, 0, 0, 0, 0, 0, 0, 0,
			0, 0, 0, 0, 0, 0, 0, 0, 0, 0,
			0, 0, 0, 0, 0, 0, 0, 0, 0, 0,
			0, 0, 0, 0, 0, 0, 0, 0, 0, 0,
			0, 0, 0, 0, 0, 0, 0, 0, 0, 0,
			0, 0, 0, 0, 0, 0, 0, 0, 0, 0,
			0, 0, 0, 0, 0, 0, 0, 0, 0, 0,
			0, 0, 0, 0, 0, 0, 0, 0, 0, 0,
			0, 0, 0, 0, 0, 0, 0, 0, 0, 0,
			1, 0, 0, 1, 1, 1, 0, 0, 0, 0,            
			1, 1, 1, 1, 1, 1, 1, 0, 0, 0,            
			1, 1, 1, 1, 1, 1, 1, 0, 0, 0,            
			1, 1, 1, 1, 1, 1, 1, 1, 0, 0,
			1, 1, 1, 0, 0, 1, 1, 1, 0, 0
		],
		"shapes": [4, 0, 3, 5, 3, 4, 1, 2]
	},
    {
        "hint": "7 of 10",
		"start": [0, 0, 0, 0, 0, 0, 0, 0, 0, 0,
			0, 0, 0, 0, 0, 0, 0, 0, 0, 0,
			0, 0, 0, 0, 0, 0, 0, 0, 0, 0,
			0, 0, 0, 0, 0, 0, 0, 0, 0, 0,
			0, 0, 0, 0, 0, 0, 0, 0, 0, 0,
			0, 0, 0, 0, 0, 0, 0, 0, 0, 0,
			0, 0, 0, 0, 0, 0, 0, 0, 0, 0,
			0, 0, 0, 0, 0, 0, 0, 0, 0, 0,
			0, 0, 0, 0, 0, 0, 0, 0, 0, 0,
			0, 0, 0, 0, 0, 0, 0, 0, 0, 0,
			0, 0, 0, 0, 0, 0, 0, 0, 0, 0,
			0, 1, 1, 0, 1, 1, 0, 0, 0, 0,
			0, 1, 1, 0, 1, 1, 0, 1, 1, 0,
			0, 1, 1, 0, 1, 1, 0, 1, 1, 0,
			0, 1, 1, 0, 1, 1, 0, 0, 0, 0,
			0, 1, 1, 1, 1, 1, 0, 1, 0, 0,
			0, 1, 1, 1, 1, 1, 0, 1, 1, 0,
			0, 1, 1, 0, 1, 1, 0, 1, 1, 0,
			0, 0, 1, 0, 1, 1, 0, 1, 1, 0,
			0, 0, 1, 0, 1, 1, 0, 0, 1, 0
		],
		"shapes": [1, 1, 0, 0, 2, 2, 1, 2, 0, 0, 3, 3]
	}]
}